4
4
5
2
6
1 1 0 0 0 0
0 0 0 0 1 0
1 1 0 0 0 0
1 0 0 1 0 1
0 1 0 0 1 0
0 0 1 1 0 0
